###############################
# ..#.......#........#........#
#...#.......#........###......#
#...#.......#..*.......#......#
#.......*...#..........#......#
#...........#........###...*..#
#   #................#....... #
#...#   .......*     # ...... #
#.. ###.........#   ......    #
#..*..# ....    # ........ #  #
#.... #  ...... #   ...... #  #
#   ###     *   # .....    ####
#...# ......... # .......     #
#.............. #  .......*.. #
#    *................        #
###############################